---------------------------------------------------------------------------------------------------------------------------
                                            apple : elma
                                            fence : bahçe çiti
                                             poet : şair
                                            prose : resim
                                             poem : şiir
                                             roar : kükremek
                                   wrapping paper : kaplık
                                          iceberg : marul
                                          give in : teslim olmak
                                           subtle : anlaşılması güç
                                           warden : dolaşmak
                                            vague : belli belirsiz
                                            vogue : moda
                                          die off : ...'dan ölmek
                                        checker's : dama
                                            exile : sürgün
                                        detuction : çıkarım
                                      iron curter : berlin duvarı
                                             bark : havlamak
                                            never : hiç; asla
                                        some time : bir süre
                                         sometime : bazen
                                        blackmail : şantaj
                                      screwdriver : tornavida
                                       the former : birincil
                                       the letter : ikincil
                                        Blackship : Yüzkarası
                                            Solar : Güneş'e ait
                                            Lunar : Ay'a ait
                               the late President : merhum Başkan
                                             Tail : Zahmet
                                            Depth : Derinlik
                                           Desert : Terk etmek
                                          abandon : Terk Etmek
                                          Dessert : Tatlı
                                           Relief : Rahatlık
                                          Relieve : Rahatlamak
                                            Brace : Diş Teli
                                            Paper : Kağıt
                                           Papers : Gazete
---------------------------------------------------------------------------------------------------------------------------
                                              man : adam
                                              men : adamlar
                                            woman : kadın
                                            women : kadınlar
                                         children : çocuklar
                                            child : çocuk
                                            teeth : dişler
                                            tooth : diş
                                           person : kişi; insan
                                           people : kişiler; insanlar
                                            mouse : fare
                                             mice : fareler
                                             feet : ayaklar
                                             foot : ayak
                                           cattle : sığır; sığırla
                                             news : haber; haberler
                                         aircraft : hava taşıtı; hava taşıtları
                                             deer : geyik; geyikler
                                             fish : balık; balıklar
                                              gas : benzin
                                            shelf : raf
                                            there : orada
                                           basket : sepet
                                             desk : sıra
                                      parking lot : park yeri
                                           seldom : nadiren
         hardly ever; scarcely ever; almost never : hemen hemen hiç
           almost; nearly; virtually; practically : hemen hemen; neredeyse
                                         blow out : söndürmek
                                          blow up : patlatmak
                                        blow over : dinmek
                                           device : alet; cihaz
                                           devise : icat etmek
                                         work for : bir yerde geçici çalışmak
                                           notice : ilan
---------------------------------------------------------------------------------------------------------------------------
                                       occupation : iş
                                           worker : işçi
                                             lift : kaldırmak
                                         suitcase : valiz; bavul
                                      sing a song : şarkı söylemek
                                          Albania : Arnavutluk
                                         Albanian : Arnavut
                                           Cyprus : Kıbrıs
                                          Cypriot : Kıbrıslı
                                      Azerbaijani : Azeri
                                             flat : apartman dairesi; düz
                                             honk : korna çalmak
                                            visit : ziyaret etmek
                                         describe : tarif etmek; tanımlamak
                                           dinner : akşam yemeği
                                        what time : saat kaç
                                          meeting : toplantı
                                          patient : sabırlı
                                           butter : tereyağı
                                  stainless stell : paslanmaz çelik
                                             dram : üzgün
                                            a few : birkaç
                                      quite a few : epeyce; oldukça
                                         a little : bir miktar
                                             mean : anlamına gelmek
                                          mean to : kastetmek; niyet etmek
                                     a loud noise : gürültü
                                           advice : öğüt; öneri; tavsiye
                                           advise : öğüt vermek; öneri vermek; tavsiye vermek
                                         practice : deneme yapmak
                                         practise : deneme
                                        back then : o zamanlar
                                           govern : yönetmek
                                         governer : yönetici; vali; hükümet
                                            roast : kavrulmuş
                                         chickpea : çekirdek
                                            baker : fırıncı
                                           bakery : dışarıda olan fırın
                                             oven : ocak
                                             cell : hücre
---------------------------------------------------------------------------------------------------------------------------
                                               we : biz
                                              our : bizim
                                             ours : bizimki
                                              lie : yalan söylemek; uzanmak
                                              lay : yaymak; sermek; masanın üstünü kurmak
                                         lay eggs : yumurtlamak
                              put someone through : birini bir yere bırakmak
                                      nail dipper : tırnak makası
                                          already : zaten
                                             trim : süs; düzeltmek; süslemek
                                             just : az önce
                                              yet : henüz
                                             ever : hiç
                                            never : asla
                                            since : -den beri
                         recently; lately; so far : son zamanlarda
                                           before : önce
                                    out of breath : nefes nefese
                top; peak; summit; climax; zenith : zirve
                                           gather : toplamak; anlamak
                                        throughly : adamakıllı; açık bir şekilde
      up to now; until now; yet; hitherto; by now : şimdiye kadar
right after; soon after; just after; immediately after : hemen sonra
                       chiefly; mainly; primarily : başlıca; birincil; öncelik
                                    instant yeast : hazır maya
                                          milking : süt sağma; süt sağmak
                                        honeymoon : balayı
                                           raisin : kuru üzüm
                                           run on : devamlı konuşmak; çok konuşmak
                                          secular : laik
                                        mercenary : paralı
                                            shade : nesne gölgesi
                                           shadow : canlı gölgesi
                                           willow : söğüt ağacı
                                         kindling : çıra
                        nonetheless; nevertheless : ama yine de
                                             tile : kiremit
                                         earrings : küpe
                                            blond : sarışın
                                      hairdresser : kuaför
---------------------------------------------------------------------------------------------------------------------------
                                             mrs. : bayan
                                              mr. : bay
                                            uncle : amca
                                             aunt : hala
                                            purse : çanta
                                            shirt : gömlek
                                             coat : mont; ceket
                                         trousers : pantolon
                                           gloves : eldiven
                                              tie : kravat
                                          rainbow : gökkuşağı
                                       a mechanic : tamirci
                                         a waiter : garson
                                  a civil servant : memur
                                         a tailor : terzi
                                a sales assistant : tezgahtar; kasiyer
                                      a carpenter : marangoz
                                         a sailor : denizci
                                          account : hesap
                                    an accountant : muhasebeci
                                        take over : devralmak; üstlenmek
                                        over take : sollamak
                                         comeover : ziyaret etmek 
                                         overcome : üstesinden gelmek
                                            china : çini
                                    as for; as to : -e gelince
                                         literary : edebi
                                         literaly : tam olarak; abartısız; kelime kelime
                                          conduct : yürütmek
                          as of; from ... onwards : -e gelince
                                  quite some time : oldukça bir süredir
                              burst into laughter : kahkahaya boğulmak
                                        currently : şu an
                                        no wonder : merak yok; endişe yok
                                       recistered : tescilli
                scent; ordour; fragrance; perfume : koku
                                              fit : kıyafet ölçüleri uymuşsa
                                             suit : rengi uymuşsa
              by; with; through; via; by means of : yoluyla; tarafından
                                      rather than : -den ziyade
---------------------------------------------------------------------------------------------------------------------------
                                   burst into cry : gözyaşlarına boğulmak; gözyaşına boğulmak
                                        blackship : yüz karası
                                        blackmail : şantaj
                                            screw : vida
                                      screwdriver : tornavida
                                       the former : başlıca; birincil
                                       the latter : ikincil
                                            solar : Güneş'e ait
                                            lunar : Ay'a ait
                               the late president : merhum başkan
                                             tail : zahmet
                                            depth : derinlik
                                  desert; abandon : terk etmek
                                           desert : çöl
                                          dessert : tatlı
                                           relief : rahatlık
                                          relieve : rahatlamak
                                            brace : diş teli
                                      withdrawing : geri çekilmek
                                            paper : kağıt
                                           papers : gazete
                                              yet : henüz
                                           relief : rahatlık
                                          relieve : rahatlamak
                                           avidly : heyecanlı
                                            fancy : hoş; cici
                                      in spite of : -e rağmen; durumunda
                                             cold : soğuk algınlığı
                                   prosperus life : varlıklı yaşam; varlıklı hayat
                                          just as : tıpkı
                                       day by day : günden güne
                                        immensely : son derece
                                       light bulb : ampul
                                        privately : gizli olarak; gizli bir şekilde; gizlice
                                            reins : dizgin
                                           vessel : gemi; damar
                                             vein : damar
                                           artery : atar damar
                           attic; penthouse; loft : çatı katı
                                    controversial : tartışmak
---------------------------------------------------------------------------------------------------------------------------
                                         cucumber : salatalık
                                            salad : salata
                                     compensation : tazminat
                                         Godspeed : Tanrı yardımcın olsun
           I'm willing to let bygones be bygones. : Eski defterleri kapatmaya hazırım. ; Geçmişi mazide bırakmaya hazırım. 
                                  deferred to you : sana danıştım
                                    on the double : ikile
                                           dinner : akşam yemeği
                                          patient : sabırlı
                                pass me the sugar : şekeri ver
                                          Belgium : Belçika
                                          Belgian : Belçikalı
                                           cooker : ocak
                                           sailor : denizci
                                          apricot : kayısı
                                          Turkish : Türkçe; Türk
                                          English : İngilizce; İngiliz
                                          Russian : Rusça; Rus
                                           French : Fransızca; Fransız
                                          Chinese : Çince; Çinli
                                        Hungarian : Macarca; Macar
                                        Bulgarian : Bulgar; Bulgarca
                                         Albanian : Arnavut; Arnavutça
                                         Armenian : Ermeni; Ermenice
                                         Japanese : Japon; Japonca
                                    edging me out : dışlanmak
                                             near : yakınında
                                          next to : bitişiğinde
                                      in front of : nesnenin önünde
                                     the front of : nesnenin ön kısmında
                              across; opposite to : karşısında
                                 on the corner of : köşesinde
                                        preschool : anaokulu
                                             sofa : kanepe
                                            stove : soba
                                             cage : kafes
                                      wastebasket : çöp sepeti
                                               by : kenarında; yanında
                                        navy blue : lacivert
---------------------------------------------------------------------------------------------------------------------------
                                       journalist : gazeteci
                                         sneakers : spor ayakkabı
                                     Thanksgiving : Şükran Günü
                                            ralph : kusmak
                                             yell : bağırmak
                                         describe : tanımlamak
                                           public : kamu
                                      embarrassed : mahçup; utangaç
                                convenience store : market
                              whale on each other : birbirine yüklenmek
                                            gosh! : Allah Allah!
                                       lighten up : gevşemek
                                        lap dance : kucak dansı
                                      sublime art : yüce sanat
                                           buffet : büfe
                                             yams : yer elması
                                            forty : kırk
                                            funds : para kaynağı; yatırımlar
                                    unpredictable : öngörülemeyen; öngörülemez
                                          servant : hizmetçi
                                        afternoon : öğleden sonra
                                            small : fiziksel olarak küçük; boyut olarak küçük
                                           little : yaş olarak küçük
                                      hardworking : çalışkan
                                             long : uzun
                                             tall : boyut olarak uzun
                                     large family : geniş aile
                                             rich : zengin
                              there is; there are : var
                                             hard : sert; zor; sıkı
                                             soft : yumuşak
                                        the hairs : saçlar
                                            hairs : kıllar
                                             hair : saç
                                             grit : kum
                                             dirt : çamur
                                         shepherd : çoban
                                             rice : pirinç
                                            liter : litre
                                           litres : çoğul anlamda litre
---------------------------------------------------------------------------------------------------------------------------
                                      living room : oturma odası
                                          seaside : deniz kenarı; deniz kıyısı
                                             mall : AVM; alışveriş merkezi
                                           kettle : çaydanlık
                                       downstairs : alt kat; aşağı kat
                                         upstairs : üst kat; yukarı kat
                                     summer house : yazlık
                                             able : -ebilmek; -abilmek
                                         actually : aslında
                                            agree : anlaşmak; kararlaştırmak; onaylamak
                                             bell : zil
                                            coast : kıyı
                                           column : kolon; sütun
                                         compound : madde
                                         consider : düşünmek
                                            crowd : kalabalık
                                           decide : karar vermek
                                         describe : açıklamak; tanımlamak; tarif etmek
                                        determine : belirlemek
                                         develope : geliştirmek
                                        developer : geliştirici
                                              fin : yüzgeç
                                            pasta : makarna
                                              pub : bar
                                       hitting on : kıza, erkeğe asılmak
                                       bridesmaid : nedime
                                           anchor : spiker; sunucu
                                       bridesmaid : nedime
                                   farmers market : pazar
                                           common : ortak
                                            crowd : kalabalık
                                         equation : denklem
                                         fraction : parça
                                             into : içine
                                     kind; gentle : kibar
                                             pair : çift
                                             seat : koltuk
                                            stick : yapışmak
                                              sum : özet
                                            thick : kalın; belirgin
                                      thunderbolt : yıldırım
---------------------------------------------------------------------------------------------------------------------------
                              down on bended knee : diz üstü çökmek
                                           mirage : serap
                                     moves on you : sana yürümek; sana asılmak
                                           unless : eğer (if + not)
                                        buttercup : düğün çiçeği
                                      weennie ass : saçma
                                           tongue : dil
                                             doof : salak
                                  some snowflakes : biraz kar tanesi
                                            faith : kader
                                          kind of : aslında
                                              tux : smokin
                                            bride : gelin
                                             maid : hizmetçi
                  Can you give me a hand, please? : Bana yardım edebilir misiniz, lütfen?; Bana yardım edebilir misin, lütfen?
                                            proud : gurur duymak
                                        concerned : endişe etmek; endişelenmek
                                  inappropriately : uygunsuz
                                      needlepoint : oya işi
                                         approach : yaklaşmak
                                          elegant : şık; zarif; kalifiye
                                           cranky : huysuz
                                             mojo : cazibe
                                            floss : diş ipi
                                             neat : sek (içki)
                                         precious : değerli
                                             hurl : savurmak; fırlatmak
                                          staring : bakmak
                                            cough : öksürük
                                           ambush : pusu; tuzak
                                           grudge : kin; öfke
                                             sunk : battı
                                          blossom : çiçek
                                            deuce : ikili
                                             take : götürmek
                                            bring : getirmek
                                              vet : veteriner
                                             tidy : toplamak
                                         memorize : ezberlemek
---------------------------------------------------------------------------------------------------------------------------
                                 be divorced from : -dan boşanmak; -den boşanmak
                                             pure : namuslu; temiz
                                     off the grid : ortada yok
                                      humiliating : küçük düşürücü
                                        embrassed : utandırıcı; mahçup edici
                                     kindergarten : kreş; anaokulu
                                           recess : ara; tenefüs
                                         g-friend : sevgili
                                             saga : destan
                                         confront : yüzleşmek
                                            gross : iğrenç
                                            phase : evre
                                             brat : velet
                                           diaper : bebek bezi
                                           sundae : dondurma
         at the moment; at this moment; currently : şu anda; şimdi
                                         nowadays : bugünlerde; şimdilerde
                                             dumb : aptal
                                       absolutely : kesinlikle
                                          evening : akşam
                                          morning : sabah
                                         beverage : içecek
                                            runny : cıvık
                                       flat broke : beş parasız
                                       internship : staj
                                        afternoon : öğleden sonra
                                          sketchy : kabataslak
                                           hustle : acele
                                         weekends : haftasonları
                                          evening : akşam
                                            lunch : öğle yemeği
                                          holiday : tatil
                                 graduation party : mezuniyet partisi
                                           Sweden : İsveç
                                      Switzerland : İsviçre
                                           summer : yaz
                                           spring : bahar
                                            order : sipariş etmek; ısmarlamak; sipariş vermek
                                          deserve : hak etmek
---------------------------------------------------------------------------------------------------------------------------
                                             jerk : sersem
                                    freshman year : birinci yıl
                                    peer preasure : çevre baskısı
                                         assembly : toplantı
                                           psyhed : heyecanlı
                                          tremors : titreme; sarsıntı
                                         declawed : tırnaksız
                                          bouncer : koruma
                                              beg : yalvarmak; dilenmek
                                       delightful : hoş; tatlı
                                         scabbard : kın
                                            noble : asil; soylu
                                     subconscious : bilinçaltı
                                    manifestation : ürün
                                           ruling : karar
                                       vulnerable : hassas
                                  keep the change : üstü kalsın
                                     conversation : konuşma; toplantı
                                        exhausted : yorgun; bitkin
                                      on weekends : haftasonlarında
                                  in the mornings : sabahları
                                  in the evenings : akşamları
                                             prom : balo
                                           always : her zaman
                                          usually : genellikle
                               frequently; rarely : sık sık
                                   seldom; rarely : nadiren
                                        sometimes : bazen
                                            rumor : söylenti
                                             noon : öğle
                                         pathetic : zavallı
                                          impulse : dürtü
                                          banquet : ziyafet
                                       profession : iş
                               hooker; prostitute : fahişe
                                         adorable : çok güzel
                                          hayseed : aptal
---------------------------------------------------------------------------------------------------------------------------
                                            slump : çöküş
                                      locker room : soyunma odası
                                          naptime : uyku vakti
                                        coworkers : iş arkadaşları
                                         chitchat : geyik sohbeti yapmak; laflamak; sohbet etmek; muhabbet etmek
                                           borrow : ödünç almak
                                           cranky : huysuz
                                        paralegal : avukat yardımcısı
                                         clerical : büro; ofis
                                           insult : hakaret
                                            whore : hakaret
                                              cap : taksi
                                nervous breakdown : sinirsel çöküş
                                           napkin : peçete
                                              odd : tuhaf
                                  classical music : klasik müzik
                                         shopping : alışveriş
                                   have breakfast : kahvaltı yapmak
                                        how often : ne sıklıkla
                    Who do you call an emergency? : Bir aciliyette kimi ararsın?; Acil bir durumda kimi ararsın?
                                  melignant tumor : meme kanseri; göğüs kanseri
                                   throwing party : parti vermek; parti düzenlemek; parti yapmak
                                          packing : toplamak
                                         investor : yatırımcı
                                             rice : pirinç
                                        go abroad : yurtdışına gitmek
                                      looking for : aramak
                                            bench : bank
                                    drawing money : para çekmek
                                              sew : dikiş dikmek
                                           attend : katılmak
                                           resent : gücenmek
                                             trap : tuzak
                                      prosecution : soruşturma
                                             case : dava
                                           granny : büyükanne
                                          conquer : fethetmek
                      commit; dedicate to; devote : adamak
                                           affect : etkilemek
                                           effect : etki
---------------------------------------------------------------------------------------------------------------------------
                                       relatively : nispeten
                                     respectively : sırasıyla
                        as regards; as to; as for : -e gelince, -iken
                                    distinguished : seçkin; gözde
                                     all together : hep birlikte
                                       completely : tamamen
                                              too : oldukça fazla; aşırı; oldukça
                                           enough : yeterince; yeteri kadar
                                            tight : sıkı
                                          courage : cesaret
                                       courageous : cesur
                                        encourage : cesaretlendirmek; teşvik etmek
                                       discourage : cesaretini kırmak
                                    encouragement : cesaretlendirme; teşvik
                                   discouragement : cesaretini kırma
                                         abstract : öz; soyut
                                          curator : müze müdürü
                                         wayfarer : yaya yolcu
                                         seafarer : denizci
                                          aviator : havacı
                                         aviation : havacılık
                                         bird flu : kuş gribi
                                        stem from : -den kaynaklanmak
                          take into consideration : dikkate almak; göz önünde bulundurmak; düşünmek; karar vermek
                                take into account : dikkate almak; göz önünde bulundurmak; düşünmek; karar vermek
                        consider; take heed; heed : dikkate almak; göz önünde bulundurmak; düşünmek; karar vermek
                                         teenager : 13-19 yaş arası genç kesim
                                         call for : çağrışımda bulunmak; anımsatmak
                                          counter : tezgah
                             candidate; applicant : aday
                                             tear : yırtmak; göz yaşı
                                           upward : yukarı doğru
                                         downward : aşağı doğru
                                             clue : ipucu
                                  cue; mark; sign : işaret
                                           admire : hayran olmak
                                        have; own : sahip olmak
                                           belong : ait olmak
                                          possess : sahip olmak
                                          realize : farkına varmak
---------------------------------------------------------------------------------------------------------------------------
                                              owe : borçlu olmak
                                             mean : kastetmek; anlamına gelmek
                                              see : görmek
                                           seeing : buluşmak; görüşmek
                                            smell : kokmak
                                         smelling : koklamak
                                            taste : tat
                                          tasting : tatmak
                                        have; has : sahip olmak
                                           having : geçiriyor
                                            looks : görünmek
                                             look : bakmak; görmek
                                      sounds good : kulağa hoş geliyor; kulağa iyi geliyor
                                            space : özgürlük
                                         utensils : kap kaçak
                                            cause : çünkü
                                           belong : ait olmak
                                             mean : kastetmek; anlamına gelmek
                                          workout : egzersiz
                            a fistfull of Dollars : bir avuç Dolar
                       little red riding the hood : kırmızı başlıklı kız
                                      I am around : Buralardayım
                                      bring about : sebep olmak
                                        see about : halletmek
                               to (nesne başında) : -e; -a
                                to (fiil başında) : -mak; -mek; -mak için; -mek için
                              for (nesne başında) : için; süreyle; -dan; -den
                                             with : ile; -lı; -li
                                               by : tarafından; yoluyla; kenarında; yanına; -e göre; -e kadar
                                         about to : üzere; eşiğinde
                                            about : hakkında; yaklaşık
                                      bring about : sebep olmak
                                        see about : halletmek
                                      riding hood : kapşon
                                      documentary : belgesel
                                          be here : burada ol
                                             host : ev sahipliği yapmak; ağırlamak
                                       last night : geçen gece
                                yesterday morning : geçen sabah; dün sabah
                                yesterday evening : geçen akşam; dün akşam
---------------------------------------------------------------------------------------------------------------------------
                              yesterday afternoon : dün öğleden sonra
                                    breast cancer : göğüs kanseri
                                       act of God : Tanrı'nın taktiri
                                       incredable : inanılmaz
                                          nervous : gergin
                                         ordinary : sıradan
                                        preordain : alın yazısı
                                      crew member : kabin görevlisi
                                            dirty : kirli
                                        was; were : -dı geçmiş zaman; -di geçmiş zaman
                                             fake : tezgahlamak
                                        primitive : ilkel
                                          concert : konser
                                a few minutes ago : birkaç dakika önce
                                          bygones : mazi; geçmiş
                                            carry : taşımak
                                    ring the bell : zili çalmak
                                            thief : hırsız
                                             vase : vazo
                                  became a father : baba oldu
                                         studying : ders çalışmak
                                             move : taşınmak
                                   I had a dream. : Rüya gördüm.
                                       vulnerable : hassas; korumasız
                                        valueable : değerli
                       how long did the film last : film ne kadar sürdü
                                     begin; start : başlamak
                                     combing hair : saç taramak
                               I have a tootache. : Dişim ağrıyor. (Geniş Zaman); Diş ağrım var.
                              I had an operation. : Bir operasyon geçirdim. 
                                            steak : biftek
                                             beef : sığır eti
                                        get tired : yorulmak
                                             pros : iyi yan; avantaj; fayda
                                             cons : kötü yan; dezavantaj; zarar
              Actually, it has its pros and cons. : Aslında, iyi yanları da var kötü yanları da. ; Aslında, yararı ve zararı var. 
                                        last week : geçen hafta
                                        next week : gelecek hafta
                                          tonight : bu gece
                                             soon : yakında; birazdan
---------------------------------------------------------------------------------------------------------------------------
                                      calori book : kalori cetveli
                                          blanket : battaniye
                                         probably : muhtemelen
                                   take your time : acele etme
                                      if you like : eğer beğenirsen; eğer istersen
                            give am/is/are a lift : arabayla bırakmak
                                             bite : ısırmak
                                         gorgeous : muhteşem
                                           resign : istifa etmek
                                  post the letter : mektubu postalamak
                                          recover : kurtarmak; iyileşmek
                                          thirsty : susamak
                                           circus : sirk
                     a lot of; lots of; plenty of : çok (olumlu, sayılabilen/sayılamayan, nesne miktarını belirten)
                                      a number of : çok (olumlu, sayılabilen, nesne miktarını belirten)
                                            a lot : çok (olumlu/soru, eylem miktarını belirten)
                                            a few : birkaç (sayılabilen)
                                         a little : bir miktar (sayılamayan)
                                              few : çok az (sayılabilen)
                                           little : çok az (sayılamayan)
                                             much : çok (olumsuz/soru, sayılamayan)
                                             many : çok (olumsuz/soru, sayılabilen)
                                             some : biraz
                                         very; so : çok
                                              too : aşırı; oldukça
                                             only : sadece
                                      Let him be. : Bırak olsun.
                                            aware : farkında olan
                                        attention : ilgi
                                             tent : çadır
                                          walk up : boyunca yürümek
                                       get packed : hazırlanmak; toparlanmak
                                     fishing pole : balık oltası
                             any minute; any time : her an; herhangi bir zaman
                                      have a rest : dinlenmek
                                    disabled spot : engelli alanı
                                            wheat : buğday
                                           cherry : vişne; kiraz
                                      sour cherry : vişne
                                           fasten : bağlamak
---------------------------------------------------------------------------------------------------------------------------
                                           submit : teslim etmek; sunmak
                                           polite : kibar
                                    Do you think? : Sence?
                                          century : yüzyıl
                                          amusing : eğlenceli
                                            handy : kullanışlı
                                              can : teneke kutu; konserve
                                          warrant : belge; sözleşme
                                           indoor : içeri; kapalı alan
                                          outdoor : dışarı; açık alan
                                         evidence : kanıt
                                         slippery : kaygan
                                         innocent : masum
                                           guilty : suçlu
                                     window shade : perde
                                          testify : ifade vermek
                                     making sense : mantıklı
                                         manifest : üretmek
                                              eel : yılan balığı
                                          suppose : sanmak; zannetmek; ummak
                                        I suppose : Sanırım; Bence
                                        wander of : etrafta dolaşmak
                                          destiny : kader
                                 return the money : parayı iade etmek; para iadesi yapmak
                                             mind : akıl; zihin; umursamak
                                           regret : pişman olmak
                                  asking for help : yardım istemek
                                             mind : akıl; zihin; umursamak
                        putting out the cigarette : sigarayı söndürmek
                       as you wish; help yourself : dilediğiniz gibi; keyfin bilir
                                      walked back : yürüyerek dönmek; geri dönmek
                                        interrupt : yarıda kesmek
                                             take : götürmek
                                            stick : sopa
                                             hive : arı kovanı
                                        financial : finansal
                                             need : ihtiyaç
                                           supply : karşılamak
                                          baffled : şaşkın; şaşırmış
                                             gunk : yapıştırıcı madde
---------------------------------------------------------------------------------------------------------------------------
                                      entire year : bütün yıl; tüm yıl
                                           during : boyunca
                                         call off : vazgeçmek; son vermek
                                       comprehend : kavramak; anlamak
                                             deny : inkar etmek; reddetmek
                                             then : öyleyse
                                     World Series : Dünya Kupası
                                           locate : yerleştirmek; yerini saptamak
                                           though : yine de
                                           stitch : dikmek
                               convince; persuade : ikna etmek
                                            logic : mantık
                                             save : biriktirmek
                                          on time : zamanında
                                             when : -dığında
                                            while : -iken
                                answering service : sekreter
                                             pout : somurtmak
                                             butt : popo; izmarit
                                              get : binmek
                                      fall asleep : uyuyakalmak
                                          discuss : tartışmak
                                       just; only : sadece
                                            annoy : kızdırmak
                                           insist : ısrar etmek
                                    have a picnic : piknik yapmak
                                            cause : sebep olmak; yol açmak; neden olmak
                                       as soon as : yapar yapmaz
                                            until : -e kadar
                                      by the time : -e kadar; dığında/diğinde
                                               as : -iken
                                          just as : tam o sırada; tıpkı
                                              nap : kestirme; şekerleme; kestirmek; uyuklamak
                                       lake house : göl evi
                          purposely; deliberately : kasten
                                           States : Devletler; Amerika
                                            shore : körfez; kıyı
                                         colonial : sömürge
                                          colonel : albay
---------------------------------------------------------------------------------------------------------------------------
                                             debt : borç
                                            depth : derinlik
                                          receipt : makbuz
                                           recipe : yemek tarifi
                                         lingerie : kadın iç çamaşırı
                                             veer : yön değiştirmek
                                                Hi : Merhaba
                                          practice : deneme
                                               saw : testere
                                              much : çok
                                             a lot : çok
                                          a little : biraz; bir miktar
                                             a bit : birazcık
                                             quite : oldukça
                                          slightly : birazcık
                                            sorrow : üzüntü
                           The sooner the better.  : Ne kadar erken o kadar iyi. 
                                            crisis : kriz
                                              warn : uyarmak
                                             agile : çevik
                                             fruit : meyve
                                         vegetable : sebze
                                            common : yaygın
                                            narrow : dar
                                            gentle : nazik
                                              good : iyi
                                            better : daha iyi
                                          the best : en iyi
                                               bad : kötü
                                             worse : daha kötü
                                         the worst : en kötü
                                               far : uzak
                                  farther; further : daha uzak
                        the farthest; the furthest : en uzak
                                        much; many : çok; fazla
                                              more : daha çok; daha fazla
                                          the most : en çok; en fazla
                                            little : az
                                              less : daha az
                                         the least : en az
---------------------------------------------------------------------------------------------------------------------------
It is the best one on the table. ; It's the best one on the table.  : Halihazırda en iyisi o. 
                                            wealth : zengin
                                         resilient : çabuk iyileşen
                                         extractor : zihin okuyucu
                                          precious : kıymetli; değerli
                                            assume : varsaymak
                                               get : almak
                                         have; has : sahip olmak; yaşamak
                                          swimming : yüzme; yüzmek
                                           crowded : kalabalık
                                           crowded : kalabalık
                                               sly : kurnaz
                                                ox : öküz
                                         tangerine : mandalina
                                              just : tam; şimdi
                                            nearly : neredeyse; hemen hemen
                                         not quite : tam olarak değil
                                           crooked : eğri
                                              wise : bilge
                                            salary : maaş
                                 What is he like?  : O nasıl biri? 
                          What does he look like?  : Onun tipi nasıl?; O nasıl görünüyor?; O nasıl gözüküyor? 
                                         like that : o şekilde; o gibi
                                             alike : birbirine benzer
                                              like : benzer
                                         lookalike : benzeri kopyası
                           the same as; similar to : X, Y ile benzer. ; X, Y ile aynıdır. 
                                         different : farklı
                                    different from : X, Y'den farklı. 
                                          the same : aynı; birbirinin aynı
                                           insured : sigortalı
                                              loss : kaybetmek
                                            addict : bağımlı
                                            a mule : katır
                                         condition : durum; kondisyon
                                           worried : endişeli
                                              even : -sa bile
                                          sentence : alıştırma
                                          composer : besteci; şarkıcı
                                             rival : rakip
---------------------------------------------------------------------------------------------------------------------------
                                       just before : hemen önce; biraz önce; az önce
                                      this morning : bu sabah
                                      for two days : iki gündür
                                            so far : şu ana kadar
                                              been : gitmiş geri dönmüş
                                              gone : gitmiş geri dönmemiş
                                              term : dönem
                                               for : -dır; -dir; süreyle; boyunca
                                             since : -den beri
                                            butter : tereyağı
                                             chase : kovalamak; uğraşmak
                                          anything : herhangi bir şey
                                        two on two : ikide iki
                                       Forget you! : Unut gitsin! 
                                             actor : erkek oyuncu
                                           actress : kadın oyuncu
                                           logical : mantıklı
                                             shout : bağırmak
                                              term : dönem
                                  recently; lately : son zamanlarda
                                            decade : on yıl
                                          at least : en azından
                                           cripple : sakat
                                        pretending : rol yapmak; numara yapmak
                                          regiment : askeri alay
                                       reinforcing : güçlendirmek; geliştirmek
                                          battling : mücadele etmek; savaşmak
                                             stamp : posta pulu
                                              dime : kuruş
                                       hummingbird : sinekkuşu
                                         the court : mahkeme
                                           mobster : gangster
                                           migrate : göç etmek
                                            gloves : eldiven
                                             until : -e kadar
                                             swirl : döndürmek
                                          spanking : şamar
                                     knock on wood : tahtaya vurmak (nazar değmesin anlamında)
---------------------------------------------------------------------------------------------------------------------------
                                 not jinx yourself : kendine nazar değmesin
                                          graduate : mezun olmak
                                         got a job : bir işe girmek
                                            bandit : haydut
                                       for a while : bir süredir
                       things had been building up : her şey üst üste geliyordu
                                        estinguish : ateş sönmek
                                          collapse : yıkılmak
                                           instead : yerine
                                            dating : flört; sevgili
                                            ground : zemin
                                I came into room.  : Odaya girdim. 
                                       soaking wet : sırılsıklam
                                        translator : çevirmen
                                           swollen : şişmiş
                                         exhausted : bitkin; yorgun
                                          straight : aralıksız; düz
                                            Venice : Venedik
                                            so far : şu ana kadar
                                       destination : varış yeri
                                            ashore : karaya; kıyıya
                                             cigar : puro
                                            favour : iyilik
                                             beach : plaj; kumsal
                                   by the time; by : -e kadar; -dığında; -diğinde
                                            dazzle : göz kamaştırmak
                                           perhaps : belki
                                a police inspector : polis müfettişi
                                         a duchess : düşes
                                             treat : davranmak
                                      construction : inşaat
                                          intercom : diyafon
                                        high beams : arabanın uzunları
                                    zebra crossing : yaya geçidi
                                             radio : radyo; telsiz
                                               bug : dinleme cihazı
                                          envelope : zarf
                                          approach : yaklaşmak
                                      human beings : insanoğlu
                                                as : olarak; gibi; tıpkı
---------------------------------------------------------------------------------------------------------------------------
                                             apply : başvurma
                                           footage : derleme
                                  a police captain : polis şefi
                                        disastrous : felaket
                                           outcast : serseri; dışlanmış
                                            misled : yanlış yönlendirmek
                             I figured you would.  : Seveceğini biliyordum. 
                                       instruction : talimat
                                       destruction : yıkım
                                           suppose : zannetmek
                         He didn't keep his word.  : Sözünü tutmadı. 
                                        eventually : sonuçta; nihayet
                                            slowly : yavaşça
                                              slow : yavaş
                                         carefully : dikkatlice
                                           careful : dikkatli
                                           happily : mutlu bir şekilde
                                             happy : mutlu
                                            easily : kolay bir şekilde
                                              easy : kolay
                                           angrily : sinirli bir şekilde
                                             angry : sinirli
                                            simply : basitçe
                                            simple : basit
                                          friendly : dostça
                                              ugly : çirkin
                                              bare : çıplak; yalın
                                            barely : hemen hemen; nadiren
                                             short : kısa
                                           shortly : özetle
                                              near : yakın; yakınında
                                            nearly : yaklaşık
                                              sure : kesin; emin
                                            surely : elbette
                                              live : yaşamak
                                            lively : hayat dolu
                                              lone : ıssız
                                            lonely : yalnız
                                              late : geç
                                            lately : son zamanlarda
---------------------------------------------------------------------------------------------------------------------------
                                              good : iyi
                                              well : iyi bir şekilde; kuyu; konuşma anında bir şey düşünürken
                                             treat : davranmak
                                            magpie : saksağan
                                            pajama : pijama
                                      occasionally : bazen; ara sıra
                                          suddenly : aniden
                                               act : davranmak
                                             spill : dökmek
                                       bar of soap : sabun
                                              soup : çorba
                                       but I still : ama ben yine de; ama yine de
                                 pick up the phone : telefonu açmak
                                               row : sıra
                                             lunch : öğle yemeği
                                            dinner : akşam yemeği
                                         breakfast : kahvaltı
                                              land : yere inmek
                                           subject : konu
                                            regret : pişman olmak
                                        officially : resmi bir şekilde
                                            landed : yere indi
                                           marched : yürüdü
                                           orderly : düzenli bir şekilde
                                              then : sonra
                                          and then : ve sonra
                                            native : yerli
                                         cooperate : işbirliği yapmak
                                      accidentally : yanlışlıkla; kazara
                                         nervously : gergin bir şekilde
                                        carelessly : dikkatsizce; dikkatsiz bir şekilde
                                        ever after : sonsuza dek
                                            nodded : baş salladı
                                              nodd : baş sallamak
                                       impatiently : sabırsızca; sabırsız bir şekilde; acelecice; aceleci bir şekilde
                                        hopelessly : umutsuzca; umutsuz bir şekilde
                                       have a chat : muhabbet etmek
                                           bravely : cesurca; cesur bir şekilde
                                               act : davranmak
                                        ripe fruit : olgun meyve
---------------------------------------------------------------------------------------------------------------------------
                                         something : bir şey
                                          anything : bir şey; herhangi bir şey
                                        everything : her şey
                                           nothing : hiçbir şey
                                 somebody; someone : birisi
                                   anybody; anyone : birisi; herhangi biri
                               everybody; everyone : herkes
                                    nobody; no one : hiç kimse
                                         somewhere : bir yer
                                          anywhere : bir yer; herhangi bir yer
                                        everywhere : her yer
                                           nowhere : hiçbir yer
                                             trunk : bagaj
                                        compliment : iltifat
                                    United Nations : Birleşmiş Milletler
                                         broke out : patlak verdi
                                            drawer : çekmece
                                           examine : tedavi etmek
                                           patient : hasta
                                             treat : davranmak
                                            arrest : tutuklamak
                                           Albania : Arnavutluk
                                  The Adriatic Sea : Adriyatik Denizi
                                          pleasing : memnun edici
                                           pleased : memnun
                                        figured it : anladım
                                             amuse : eğlendirmek
                                           applaud : alkışlamak
                                          pleasing : memnun edici
                                            marine : denizci
                                         submarine : denizaltı
                                          audience : seyirci; izleyici
                                    as a principle : prensip olarak
                     what comes around goes around : ne ekersen onu biçersin
                                          withdraw : geri çekilmek
                                            troops : birlik
                                             order : emretmek
                                          dead end : çıkmaz sokak
                                     public menace : kamu tehditi
                                              kite : uçurtma
---------------------------------------------------------------------------------------------------------------------------
                        He is somewhere safe now.  : O şu anda güvenli bir yerde.; O şimdi güvenli bir yerde. 
                                         in charge : yetkili; sorumlu
                                              each : her bir
                                      each student : her bir öğrenci
                                   sparkling water : maden suyu
                                     mineral water : mineralli su
                                               one : kişi; insan
                     One should always be polite.  : İnsan her zaman kibar olmalı. ; Kişi her zaman kibar olmalı.
              One cannot exist without the other.  : İnsan başkaları olmadan var olamaz. ; İnsan diğerleri olmadan var olamaz. : Kişi her zaman kibar olmalı.
                              For crying out loud! : Tanrı aşkına! 
                                           sweater : kazak
                                            drawer : çekmece
                                            myself : kendim
                                          yourself : kendin
                          herself; himself; itself : kendisi
                                        yourselves : kendiniz
                                         ourselves : kendimiz
                                        themselves : kendileri
                                       responsible : sorumlu
                                             stove : soba
                    He hit himself with a hammer.  : Çekiçle kendini yaraladı. 
                 She burned herself on the stove.  : Sobada bir yerini yaktı. 
                   I enjoyed myself at the party.  : Partide iyi vakit geçirdim. 
          We helped ourselves at the open buffet.  : Açık büfede self servis yaptık. 
                     Please behave yourselves kids.  : Lütfen uslu durun çocuklar. 
          You should apply yourself to your work.  : Kendini işine vermelisin. 
                                         represent : temsil etmek
You have to stand up for yourself every once in a while.  : Arada sırada kendini savunmak zorundasın. 
                                             scarf : şal; eşarp; tülbent
                                   Spare yourself! : Kendini kurtar!
                                        count down : geriye doğru saymak
                                   Suit yourself.  : Keyfin bilir. 
                                            tissue : mendil; peçete
                                           express : ifade etmek
                                    the Aegean Sea : Ege Denizi
                                     non-religious : dinsiz
                                        backgammon : tavla
                                          terrific : enfes
                                           climber : dağcı
                                             blind : kör
---------------------------------------------------------------------------------------------------------------------------
                                       observation : gözlem
                                 make a sugesstion : bir öneride bulunmak
                                        make money : para kazanmak
                                     make progress : ilerleme kaydetmek
                                    make a journey : seyahat etmek
                                     make a profit : kar etmek; kar yapmak
                                      make friends : arkadaş edinmek
                                         make love : sevişmek
                                    make an effort : çaba sarfetmek
                                         make time : zaman yaratmak
                                 make a difference : bir fark yaratmak
                                         make fire : ateş yakmak
                                       make a wish : bir dilek tutmak; bir dilekte bulunmak; bir istekte bulunmak
                                         do damage : zarar vermek
                                          do dance : dans etmek
                 do somebody good; do someone good : birine iyi gelir
                                       do you good : sana iyi gelir
                                     do the puzzle : bulmacayı çözmek
                                    do the laundry : çamaşırı yıkamak
                                     do the dishes : bulaşıkları yıkamak
                                      do the lawns : çimleri biçmek
                                              lawn : çim
                                                do : yapmak (eylem)
                                              make : yapmak (yaratmak)
                                          make bed : yatak düzeltmek; yatak toplamak
                                       do a favour : bir iyilik yapmak
                    make a choice; make a decision : tercih yapmak; seçim yapmak; karar vermek
                                     make a living : hayatını sürdürmek; yaşamını sürdürmek; yaşamak
                                         gardening : bahçe işi
                                           get out : çıkmak
                                               say : anlatmak (sözün kime anlatıldığı belli olmadığı durumlarda kullanılır)
                                              tell : anlatmak (sözün kime anlatıldığı belli olduğu durumlarda kullanılır)
                                              talk : konuşmak (karşılıklı halde)
                                             speak : konuşmak (tek taraflı halde)
                                         fair skin : açık ten
                  What did you say your name was?  : Adın ne demiştin? 
                                          suitable : uygun
                        He is somewhere safe now.  : O şu anda güvenli bir yerde. ; O şimdi güvenli bir yerde. 
                                                hi : merhaba
---------------------------------------------------------------------------------------------------------------------------
                                            urgent : acil
                                        get hungry : acıkmak
                 Would you like to do me a favour? : Bana bir iyilik yapar mısın? 
                                           seminar : seminer; toplantı
                                         sunk down : battı
                                                RV : karavan
                               I will do my best.  : Elimden gelenin en iyisini yapacağım. 
                        give yourself to your work : kendini işine ver
                                        as soon as : yapar yapmaz
                                               gap : boşluk
                                          get into : akla girmek; içe girmek
                                       inquisition : sorgulamak
                                    trick or treat : şaka mı şeker mi
                                        candidates : adaylar
                                         qualified : nitelikli; kalifiye; seçkin
                                             sober : ayık
                                         sunscreen : güneş kremi
                           Don't you agree to me?  : Bana katılmıyor musun? 
                              Don't you think so?  : Sence de öyle değil mi? ; Sen öyle düşünmüyor musun?
          We have seen ups and downs, haven't we?  : İnişlerimiz ve çıkışlarımız oldu, değil mi? 
                                           various : çeşitli
                                         briefcase : çanta
                           One should knows enemy. : İnsan düşmanını tanımalıdır.
                                          have fun : eğlenmek
                                  have a good time : iyi vakit geçirmek
                                      have trouble : sorun yaşamak
have difficulty; have a hard time; have a difficult time : zorlanmak
                                          stubborn : inatçı
                                    saying prayers : dua etmek
                                           payrise : zam
                                           give up : bırakmak; pes etmek
                                       get through : bitirmek
                                           put off : ertelemek
                                             enjoy : eğlenmek
                                           suggest : önermek
                                              mind : umursamak
                                                to : -mek için; -mak için
                                            no use : faydası yok
                                         (be) busy : meşgul olmak
                                        (be) worth : değmek; değer
---------------------------------------------------------------------------------------------------------------------------
                                        go fishing : balığa gitmek
                                       go swimming : yüzmeye gitmek
                                       go shopping : alışverişe gitmek
                                        go camping : kampa gitmek
                                        go bowling : bowlinge gitmek
                                         go skiing : kayağa gitmek; kaymaya gitmek
                                        go skating : paten kaymaya gitmek
                                         go hiking : yürüyüşe gitmek
                                        go boating : botla açılmak
                                        go hunting : ava gitmek
                                        go jogging : tempolu koşuya gitmek
                                        go running : koşuya gitmek
                                        go sailing : yelkenliyle açılmak
                                       go climbing : tırmanışa gitmek; tırmanmaya gitmek
                                        go dancing : dansa gitmek
                                       go sledding : kızakla kaymaya gitmek
                                           patient : hasta; sabırlı
                                         junk food : abur cubur
                                              mark : not; işaret
                                              take : binmek
                                             admit : itiraf etmek; kabullenmek
                                        anticipate : ummak
                                  hearing from her : ondan haber almak
                                        can't help : kendini alamamak
                                             avoid : kaçınmak
                                          consider : dikkate almak; düşünmek
                                       contemplate : tasarlamak; hayal etmek
                                    detest; loathe : tiksinmek; nefret etmek; iğrenmek
                                             dread : ürkmek; çekinmek
                                            permit : izin vermek
                                 recollect; recall : anımsamak
                                            resent : gücenmek; alınmak
                                            resist : direnmek; dayanmak
                                              risk : göze almak; risk
                                               dam : baraj
                                            entail : gerektirmek
                           can't stand; can't bear : dayanamamak; katlanamamak
                                             cease : kesmek; son vermek
---------------------------------------------------------------------------------------------------------------------------
                          remember + fiil (Gerund) : geçmişteki bir şeyi hatırlamak
                      remember + fiil (Infinitive) : bir sorumluluğu akıl etmek; bir sorumluluğu hatırlamak
                            forget + fiil (Gerund) : geçmişteki bir şeyi unutmak
                        forget + fiil (Infinitive) : bir sorumluluğu unutmak
                            regret + fiil (Gerund) : pişman olmak
                        regret + fiil (Infinitive) : üzüntü duymak
                               try + fiil (Gerund) : olasılıklardan birini denemek
                           try + fiil (Infinitive) : çalışmak; çaba sarf etmek; çabalamak; uğraşmak
                              stop + fiil (Gerund) : son vermek; kesmek
                          stop + fiil (Infinitive) : bir şey için durmak
                             go on + fiil (Gerund) : yarım kalan bir şeye devam etmek
                         go on + fiil (Infinitive) : bir şey ile devam etmek
                           propose + fiil (Gerund) : önermek; teklif etmek
                       propose + fiil (Infinitive) : planlamak; niyetinde olmak
                              like + fiil (Gerund) : sevmek; hoşlanmak
                          like + fiil (Infinitive) : istemek
                              love + fiil (Gerund) : sevmek; hoşlanmak
                          love + fiil (Infinitive) : istemek; arzulamak
                              care + fiil (Gerund) : umursamak; sorun etmek
                          care + fiil (Infinitive) : ilgi duymak; istekli olmak
                            no use + fiil (Gerund) : faydası yok
                         (be) busy + fiil (Gerund) : meşgul olmak
                        (be) worth + fiil (Gerund) : değmek; değer
                                           patient : sabırlı; hasta
                                         impatient : sabırsız
                                             couch : kanepe
                                    responsibility : sorumluluk
                                            commit : işlemek
                                           prevent : önlemek
                                         interrupt : söz kesmek; ertelemek; yarıda kesmek
                                          eligible : uygun
                                           ostrich : devekuşu
                                           doorway : giriş
                                         shoelaces : ayakkabı bağcıkları
                                             delay : geciktirmek
                                               tax : vergi
                                          prisoner : mahkum
                                                by : tarafından; kenarında
                                             quite : oldukça; epey
                                             quiet : sessiz; sakin
---------------------------------------------------------------------------------------------------------------------------
                                              quit : bırakmak; terk etmek; çıkmak
                                            rather : oldukça; epey; -den ziyade
                                            touchy : dokunaklı
                                   convience store : bakkal
                                             whore : fahişe; orospu
                                 if you don't mind : eğer bir sakıncası yoksa
                                            me too : ben de (olumlu anlamda)
                                        me neither : ben de (olumsuz anlamda)
                                for a while before : bir süre öncedir
                                         locksmith : çilingir
                                    would; used to : -erdi; -ardı
                                        be used to : alışkın olmak
                                       get used to : alışmak
                          You should get used to.  : Alışmalısın. 
                                   in a short time : kısa bir süre içinde; kısa bir sürede
                                        appreciate : takdir etmek
                                         evaporate : buharlaşmak
                                              melt : erimek
                                             float : hareketsiz halde yüzmek; hareketsiz şekilde yüzmek
                                               fur : kürk
                                             adopt : sahiplenmek
                                      illumination : aydınlanma
                                        light-head : sarhoş
                                             peril : tehlike
                                            pursue : takip etmek
                                           improve : kanıtlamak; gelişmek
                                   look forward to : dört gözle beklemek
                                          vengeful : kindar
                                  insult to injury : yaraya tuz basmak
                                            offend : gücendirmek; alınmak
                          preside over his funeral : cenazesini kaldırmak
                                            riddle : bilmece
                                               fur : kürk
                                             adopt : sahiplenmek
I will return your favour. ; I will pay your favour.  : İyiliğini karşılıksız bırakmam. 
                                  if I were you... : senin yerinde olsaydım...
                                               bum : serseri
                                           commute : gidip gelmek
  provided that; providing that; on condition that : ... şartıyla
                                        as long as : şartıyla; sürece
---------------------------------------------------------------------------------------------------------------------------
                              If it weren't for... : ...olmasaydı (If (Type 2))
                          If it hadn't been for... : ...olmasaydı (If (Type 3))
If it weren't for your help, I couldn't finish the work on time.  : Eğer senin yardımın olmasaydı, işi zamanında bitiremezdim. 
If it hadn't been for your help, I couldn't have finished the work on time.  : Eğer senin yardımın olmasaydı, işi zamanında bitiremeyecektim. 
                                          meddling : araya karışma
                                         paralyzed : felçli
                                          paralyze : felç olmak
                                       appointment : randevu
                                           funeral : cenaze
                                           run out : tükenmek
                                              form : kurmak; oluşturmak
                                          memorize : ezberlemek
                                       golden cage : altın kafes
                                              cage : kafes
                                       Golden Gate : Kaliforniya'da bir köprü
                                             offer : teklif
                                           step on : basmak
                                 step on the brake : frene basmak
                                         tow truck : çekici
                                           improve : gelişmek
                                       let me know : beni haberdar et; beni bilgilendir
                                        definitely : kesinlikle
                                             mourn : yas tutmak
                                             offer : teklif
                                        be damaged : hasar görmek; zarar görmek
                                          eligible : uygun
                                           if only : keşke
                                            I wish : keşke
                                          sunbathe : güneş banyosu yapmak
                                   a pair of socks : bir çift çorap
                                        medication : ilaç tedavisi
                                  Must + have + v3 : -miş olmalı; -mış olmalı
                                Should + have + v3 : -meliydi; -malıydı
                   He must not have gone too far.  : Fazla ileri gitmemiş olmalı. ; Çok uzağa gitmiş olamaz. ; Çok uzağa gitmiş olmamalı.
                              You shouldn't have.  : Zahmet etmeseydin. 
                                             stray : serseri; sapmak
                                    safety harness : güvenlik halatı; emniyet kemeri
                                      conservative : muhafazakar
                                            booked : rezerve etmek
                                    asking her out : ona çıkma teklifi etmek
---------------------------------------------------------------------------------------------------------------------------
                                     cause trouble : sorun çıkarmak; sorun yaratmak
                                    Vice President : Başkan Vekili; Başkan Yardımcısı
                                             throw : atmak; fırlatmak
                                       immigration : göçmenlik
                                             badge : rozet
                                          evacuate : tahliye etmek
                                      fire brigade : itfaiye
                                           fireman : itfaiyeci
                                          eggplant : patlıcan (Amerikan)
                                         aubergine : patlıcan (İngiliz)
                                          airplane : uçak (Amerikan)
                                         aeroplane : uçak (İngiliz)
                                        cell phone : telefon (Amerikan)
                                      mobile phone : telefon (İngiliz)
                                       parking lot : araba park yeri (Amerikan)
                                          car park : araba park yeri (İngiliz)
                                           zuccini : kabak (Amerikan)
                                         courgette : kabak (İngiliz)
                                         drugstore : eczane (Amerikan)
                                         chemist's : eczane (İngiliz)
                                            cookie : kurabiye (Amerikan)
                                           biscuit : kurabiye (İngiliz)
                                         apartment : daire (Amerikan)
                                              flat : daire (İngiliz)
                                          vacation : tatil (Amerikan)
                                           holiday : tatil (İngiliz)
                                              cart : alışveriş arabası (Amerikan); sepet (Amerikan)
                                           trolley : alışveriş arabası (İngiliz); sepet (İngiliz)
                                           starter : aperatif (Amerikan)
                                         appetizer : aperatif (İngiliz)
                                     licence plate : plaka (Amerikan)
                                      number plate : plaka (İngiliz)
                                         dog house : köpek kulübesi (Amerikan)
                                            kennel : köpek kulübesi (İngiliz)
                                         crosswalk : yaya geçidi (Amerikan)
                               pedestrian crossing : yaya geçidi (İngiliz)
                                            lumber : kereste (Amerikan)
                                            timber : kereste (İngiliz)
                                      French fries : patates kızartması (Amerikan)
                                             chips : patates kızartması (İngiliz)
---------------------------------------------------------------------------------------------------------------------------
                                          sneakers : spor ayakkabı (Amerikan)
                                          trainers : spor ayakkabı (İngiliz)
                                       garbage can : çöp tenekesi (Amerikan); çöp kutusu (Amerikan)
                                               bin : çöp tenekesi (İngiliz); çöp kutusu (İngiliz)
                                            subway : metro (Amerikan)
                                       underground : metro (İngiliz)
                                               gas : benzin (Amerikan)
                                            petrol : benzin (İngiliz)
                                             truck : tır (Amerikan)
                                             lorry : tır (İngiliz)
                                              hood : kaput (Amerikan)
                                            bonnet : kaput (İngiliz)
                                           highway : otoyol (Amerikan)
                                          motorway : otoyol (İngiliz)
                                               can : teneke kutu (Amerikan); konserve (Amerikan)
                                               tin : teneke kutu (İngiliz); konserve (İngiliz)
                                          railroad : tren yolu (Amerikan)
                                           railway : tren yolu (İngiliz)
                                             trunk : bagaj (Amerikan)
                                              boot : bagaj (İngiliz)
                                          downtown : şehir merkezi (Amerikan)
                                       city center : şehir merkezi (İngiliz)
                                           janitor : kapıcı (Amerikan)
                                        care taker : kapıcı (İngiliz)
                                           zipcode : posta kodu (Amerikan)
                                          postcode : posta kodu (İngiliz)
                                           line up : bekleme sırası (Amerikan)
                                             queue : bekleme sırası (İngiliz)
                                          elevator : asansör (Amerikan)
                                              lift : asansör (İngiliz)
                                        motorcycle : motosiklet (Amerikan)
                                         motorbike : motosiklet (İngiliz)
                                   fire department : itfaiye (Amerikan)
                                      fire brigade : itfaiye (İngiliz)
                                            forged : sahte; çakma
                                         privilege : yetki
                             travelling privileges : seyahat yetkileri; yolculuk hakları
   Don't you stand there pretend to be surprised.  : Şaşırıp kalmış numarası yapma. 
                                          get lost : kaybol
                                               mow : biçmek
---------------------------------------------------------------------------------------------------------------------------
                                              lawn : çim
                                       put up with : katlanmak
                                         blindfold : gözleri bağlı; körü körüne
                                            border : sınır
                                        tumultuous : çalkantılı
                                          pristine : önceden bozulmamış; temiz
                                         furniture : mobilya
                                              suck : emmek; içine çekmek
                                             major : branş; bölüm
                                             attic : çatı katı; tavan arası
                                          junction : kavşak
                                            square : meydan
                                           schmuck : salak; pislik
                                    record company : plak şirketi
                                             story : kat; hikaye
                               as soon as possible : en kısa sürede
                                     at the moment : şu an; şimdi
                                       interrogate : sorgulamak
                                              yell : bağırmak
                                          separate : ayrı
                                           pretend : numara yapmak; rol yapmak
                                             goofy : şapşal
                                               pal : arkadaş
                                          shepherd : çoban
                                        schoolyard : okul bahçesi
                                            edible : yenilebilir
                                       grasshopper : çekirge
                                               hop : zıplamak
                                      coffee table : sehpa
                                         pine tree : çam ağacı
                                      out of order : bozuk; hizmet dışı; tarihi geçmiş
                                               fur : kürk
                                             eject : çıkarmak; uçaktan atlamak; kovmak; atmak
                                             treat : tedavi etmek; davranmak
                                     grandchildren : torunlar
                                        grandchild : torun
                                deck chair; sunbed : şezlong
                                       spectecular : eşsiz; muhteşem
                                              crow : horoz sesi
---------------------------------------------------------------------------------------------------------------------------
                                            spring : ilkbahar
                                       just before : hemen önce; biraz önce; az önce
                                            season : mevsim
                       It can last for two hours.  : İki saat sürebilir. 
                                              puke : kusmak
                                     work overtime : fazla mesai
                                       authorities : yetkililer
                                        experiment : deney
                                           conduct : yürütmek
                                            carpet : halı
                                             decay : çürüme; çürümek
                                           decayed : çürümüş
                                            unless : -mazsa; -mezse
                                          sergeant : çavuş
                                        suspicious : şüpheliler
                                         so...that : o kadar ...(sıfat/zarf) ki 
                                       such...that : o kadar ...(sıfat tamlaması) ki
                                             so... : o kadar ...(sıfat/zarf)
                                           such... : o kadar ...(sıfat tamlaması)
                                               coy : cilveli; nazlı
                                            formal : resmi
                                          informal : resmi olmayan; gayri resmi
                                           concise : özlü
                                      warm regards : sevgilerimle
                                      best regards : saygılarımla
                                   yours sincerely : saygılarımla (arkadaş ortamında)
                                         greetings : selamlar
                                             abuse : suistimal
                                              warm : ılık; hafif sıcak
                                           retreat : geri çekilme; geri çekilmek
                                          law item : yasa maddesi; kanun maddesi
                                              none : hiçbiri
                                              most : pek çok; birçok; en çok
                                             major : binbaşı
                                        stagecoach : posta arabası
                                        nutritious : besleyici
                                       cornerstone : olmazsa olmaz; temel taş
                                       dead marine : boş şişe
                                              brag : övünmek
                                    comma; virgule : virgül
---------------------------------------------------------------------------------------------------------------------------
                                        apostrophe : kesme işareti
                         interjection; exclamation : ünlem
                                             frame : çerçeve
                                          advocate : avukat
                                       breaking up : ayrılmak; kopmak
                                 a man of his word : sözünün eri bir adam
                          Don't hurt your chance.  : Şansını zorlama. 
                                            kidnap : kaçırmak
                                        kidnapping : adam kaçırma; adam kaçırmak
                                             abort : iptal etmek
                                             wound : yara
                                             round : yuvarlak
                             Don't move a muscle!  : Kılını kıpırdatma! 
                                    offer; suggest : önermek; teklif
                                    refuse; reject : reddetmek
                                               say : anlatmak (sözün kime anlatıldığı belli olmadığı durumlarda kullanılır)
                                              tell : anlatmak (sözün kime anlatıldığı belli olduğu durumlarda kullanılır)
                                          threaten : tehdit etmek
                                           whether : -ıp -ıpmadığı; -ip -ipmediği
                                            wonder : merak etmek
                                    wanted to know : bilmek istedi
                                               ask : istemek
                                            by far : bugüne kadar; şimdiye kadar
                                             study : çalışma odası
                                  other; the other : diğeri; başkası
                                others; the others : diğerleri; başkaları
                                     other; others : bir kısmı
                                           another : bir diğeri; bir başkası; daha (nesne)
                                              more : daha fazla
                           each other; one another : birbiri
                                   every other ... : birer ... atlayarak
                                          no other : başka yok; diğeri yok
                                 one after another : birbiri ardına
                                       another one : başka biri; başka bir tane
                                        other than : haricinde; -dan başkası; -den başkası; -den ziyade; -dan ziyade
                                  other way around : tam tersi
                                            refuse : reddetmek
                                              flaw : kusur
                                          flawless : kusursuz
                                            flawed : kusurlu
                                              deaf : sağır
---------------------------------------------------------------------------------------------------------------------------
                                           handout : sadaka
                                             rough : kötü; dalgalı
                                              kite : uçurtma
                                            decent : terbiyeli
                                               see : görmek; görünmek
                          I see you another time.  : Başka zaman görüşürüz. 
                                    quotation mark : tırnak işareti
                                           jogging : tempolu yürüyüş
                     though; although; even though : -e rağmen (cümlecik öncesinde kullanılır)
                              despite; in spite of : -e rağmen (nesne öncesinde kullanılır)
  despite the fact that; in spite of the fact that : -e rağmen (cümlecik öncesinde kullanılır)
                         nevertheless; nonetheless : buna rağmen (yazılı); yine de (yazılı)
                                           however : buna rağmen (sözlü/yazılı); yine de (sözlü/yazılı)
                    however + sıfat; no matter how : her ne kadar
                      but ... still; yet ... still : ama yine de ...
                                           even so : böyle olsa bile
                                             while : -iken
                                           whereas : -iken; diğer taraftan; öte yandan; ancak
                                 on the other hand : diğer taraftan; öte yandan; bunun dışında; bunun haricinde
                                       or; or else : aksi taktirde; yoksa
                                         otherwise : aksi taktirde; yoksa; aksi (nesne); tersi (nesne)
                                  Otherwise what?  : Yoksa ne olur?; Aksi taktirde ne olur? 
                                    blood pressure : tansiyon; kan basıncı
                                         arrogance : kibir
                                             valor : cesaret; yiğitlik; kahramanlık
                                            horrid : çirkin; iğrenç
                                         blasphemi : küfür
                                          vocation : merak
                                             anger : öfke; sinir
                                             angry : kızgın; öfkeli
                                       traditional : klasik; geleneksel
                    Who are you to say otherwise?  : Sen kim oluyorsun da aksini söylüyorsun? 
                                           doll up : giyinip süslenmek
       We will make you sorry you were ever born.  : Seni doğduğuna pişman edeceğiz. 
                                         shrubbery : çalılık
                                              wood : odun; orman
                                         beam back : geri ışınlanmak
                                        enterprise : şirket
                                            betray : ihanet etmek
                                              worn : aşınmış
                                       sympathetic : sempatik
                                        vegetarian : vejetaryen
                                          scaffold : platform
                                           custody : gözaltı
                                            deputy : yardımcı
                                          creature : yaratık
---------------------------------------------------------------------------------------------------------------------------
                                              both : her iki; her ikisi
                                  both ... and ... : hem ... hem de ...
                                 either ... or ... : ya ... ya da ...
                                            either : her ikisinden biri    
                               neither ... nor ... : ne ... ne de ...
                                           neither : ikisinden hiçbiri
                         not only ... but also ... : sadece ... değil ... de
                                          castaway : kazazede
                  Would I be correct in thinking?  : Düşünmekte haklı mıyım?; Düşünmede haklı mıyım? 
                     You can step into his shoes.  : Onun yerini alabilirsin. ; Onun yerine geçebilirsin. 
                                        repatriate : ülkesine geri göndermek
                                               nag : ihtiyar at; yaşlı at
           thanks to; owing to; because of; due to : yüzünden; sayesinde; ötürü; dolayı
                                             since : için (söyleyen ve dinleyenin bildiği durumlarda kullanılır, yazılı); -den beri
                                                as : için (söyleyen ve dinleyenin bildiği durumlarda kullanılır, sözlü)
                                           because : için (söyleyen ve dinleyenin bilmediği durumlarda kullanılır)
                                               for : için (resmi durumlarda kullanılır, yazılı)
                                         therefore : bu yüzden (yazılı)
                                                so : bu yüzden (sözlü); peki (cümle başında kullanılırsa)
                                   for this reason : bu sebeple
                                      consequently : sonuç olarak (yazılı)
                                       as a result : sonuç olarak
                                              thus : böylelikle (yazılı, resmi)
                                            bidder : teklif veren
                                           synonym : eşanlamlı sözcük
                                        visa versa : tam tersi; tam zıttı
                                            mutiny : isyan
                                        prohibited : yasak
                                        theatrical : teatral
                                       instability : dengesizlik
                                           observe : gözlemlemek
                                           certain : bazı
                                        sacrifices : fedakarlıklar
                                        lieutenant : teğmen
                                           further : daha ileri
                        I can buy a lunch to you.  : Sana bir öğle yemeği ısmarlayabilirim. 
                                          advocate : avukat
                                       breaking up : ayrılmak; kopmak
                                 a man of his word : sözünün eri bir adam
                          Don't hurt your chance.  : Şansını zorlama. 
---------------------------------------------------------------------------------------------------------------------------
                                            temper : öfke
                                          wrinkles : kırışıklıklar
                                       workmanship : işçilik
                                      insufficient : yetersiz
                                           drought : kuraklık
                                         excessive : aşırı
                                         treatment : tedavi
                                       interpreter : çevirmen
                                           get wet : ıslanmak
                                          slippery : kaygan
                                         treatment : tedavi
                                in case + cümlecik : ... ihtimaline karşı; -sa diye
                      in the event that + cümlecik : ... ihtimaline karşı (yazılı, resmi); -sa diye (yazılı, resmi)
  in case ... should; in the event that ... should : ... olur da
In case you should need to reach me, my phone will be on at all times. : Olur da bana ulaşman gerekirse, telefonum daima açık olacak. 
                                 in case of + isim : ... halinde; ... durumunda
                            in the event of + isim : ... halinde; ... durumunda
                                      just in case : her ihtimale karşı
                                             spare : yedek
                                    raving lunatic : saçma sapan; uçuk kaçık
                            so that; in order that : -sın diye; -sin diye; -mek için; -mak için
                                            collar : tasma
                                          treasure : hazine
                                              rent : kira
                                          maintain : korumak; sürdürmek
                                 fire extinguisher : yangın söndürücü
                                         power cut : elektrik kesintisi
                                        without me : bensiz
                                      call in sick : mazeret bildirmek
                                            lesson : ders
                                           even if : -sa bile 
                                            manage : başarmak
                                        take apart : ayırmak; koparmak
                        whether you want to or not : istesen de istemesen de
                                           pissant : zavallı
                                              drag : sürüklemek
                                            ticket : ceza; bilet
                                          maintain : korumak; sürdürmek
                                          loyality : sadakat
                                    whether or not : öyle ya da böyle
---------------------------------------------------------------------------------------------------------------------------
                                         inspector : müfettiş
                                             orbit : yörünge
                                           curtain : perde
                                          whipping : kırbaçlama
                             Don't pay attention.  : Aldırış etme. ; Dikkate almayın. 
                                           sustain : devam etmek
                                           trouble : zorluk; sorun
                                              away : uzakta
                                          whatever : her ne
                                          wherever : her nere; her nereye; her nerede
                                          whenever : her ne zaman
                                           whoever : her kim
                                          whomever : her kimi; her kime
                                         whichever : herhangi; hangisi olursa
                                           however : her nasıl
                Whoever wants to come is welcome.  : Her kim gelmek istiyorsa kapımız açık. ; Her kim gelmek isterse kapımız açık.
                                           what to : ne -acağı; ne -eceği; ne gerektiği
                                            how to : nasıl -acağı; nasıl -eceği; nasıl gerektiği
                                          where to : nerede -acağı; nerede -eceği; nerede gerektiği
                                           when to : ne zaman -acağı; ne zaman -eceği; ne zaman gerektiği
                                            who to : kimi -eceği; kimi -acağı; kimi gerektiği
                                           whom to : kime -eceği; kime -acağı; kime gerektiği
                                      which one to : hangisini
                                     which ones to : hangilerini
                                             sense : duyu; hissetmek; haz; his
                                          let down : hayal kırıklığına uğratmak
                                            sleepy : uykulu
                                 ancient artifacts : tarihi eserler; eski mimariler
                                        footballer : futbolcu
                                          skillful : yetenekli
                    It isn't as hard as it looks.  : Göründüğü kadar zor değil.
                                             alike : birbirine benzemek
                                        unemployed : işsiz
                                         encounter : karşılaşmak
                                           expense : masraf
                                   sooner or later : er ya da geç
                                          governor : vali
                                           certain : belli; belirli
                                            perish : mahvolmak
                                          relation : akraba
                                             fleet : filo
                                          aviation : havacılık
                                           deicing : buz çözme; buz çözmek
                                            decide : karar vermek
                                         interpret : yorumlamak
                                        misleading : yanıltıcı; göz boyayıcı
                                            matter : önemli olmak; konu; mesele
---------------------------------------------------------------------------------------------------------------------------
                                           confess : itiraf etmek
                                          generous : cömert
                                   congratulations : tebrikler
                                       responsible : sorumluluk sahibi
                                           opposed : karşı
                                              fond : düşkün
                                            devote : adamak
                                           devoted : sadık
                                           attempt : girişim
                                           anxious : endişeli
                                        accustomed : alışkın
                                            absent : yok
                                           accused : sanık
                           What is he accused of?  : O neyle suçlanıyor? 
                            Do you agree with us?  : Bize katılıyor musun?
                                    be absent from : -dan yoksun olmak; -den yoksun olmak
                                     be accused of : ile suçlanmak
                                  be accustomed to : -ya alışkın olmak; -ye alışkın olmak
                                be acquainted with : -ya aşina olmak; -ye aşina olmak; tanımak
                                    be addicted to : -ya bağımlı olmak; -ye bağımlı olmak
                                      be afraid of : -dan korkmak; -den korkmak
                                        agree with : ile hemfikir olmak; katılmak
                        be angry at; be angry with : tarafından kızdırılmak
                                     apologize for : -dan ötürü özür dilemek; -den ötürü özür dilemek
                               apply to; apply for : -yı uygulamak; -yi uygulamak; -ya başvurmak; -ye başvurmak
                                       approve of  : -yı onaylamak; -yi onaylamak
                           argue with; argue about : ile tartışmak; hakkında tartışmak
                              arrive in; arrive at : -ya varmak; -ye varmak; -ya ulaşmak; -ye ulaşmak
                                be associated with : ile ilişkili olmak
                                       be aware of : -nın farkında olmak; -nin farkında olmak
                                        believe in : -ya inanmak; -ye inanmak
                                         blame for : ile suçlamak
                                   be blessed with : becerisine sahip olmak
                       be bored with; be bored for : -yı yapmaktan sıkılmak; -yi yapmaktan sıkılmak
                                     be capable of : -yı yapabilecek beceride olmak; -yi yapabilecek beceride olmak
                              care about; care for : -ya önem vermek; -ye önem vermek; -ya ilgilenmek; -ye ilgilenmek; -yı önemsemek; -yi önemsemek
                                 be cluttered with : ile dolu olmak; ile darmadağın olmak
                                   be committed to : -ya kendini adamak; -ye kendini adamak
                          compare to; compare with : ile karşılaştırmak; ile kıyaslamak
                      complain about; complain of  : -dan ötürü şikayet etmek; -den ötürü şikayet etmek
                                    be composed of : -den oluşmak; -dan oluşmak
---------------------------------------------------------------------------------------------------------------------------
                                be concerned about : -dan ötürü endişeli olmak; -den ötürü endişeli olmak
                                   be connected to : ile bağlantılı olmak; ile ilişkili olmak
                                        consist of : -dan oluşmak; -den oluşmak
                                be concerned about : -dan ötürü endişeli olmak; -den ötürü endişeli olmak
                                   be connected to : ile bağlantılı olmak; ile ilişkili olmak
                                   be connected to : ile bağlantılı olmak; ile ilişkili olmak
                                        consist of : -dan oluşmak; -den oluşmak; içermek
                                   be content with : -dan ötürü memnun olmak; -den ötürü memnun olmak
                                     contribute to : -ya katkıda bulunmak; -ye katkıda bulunmak
                                   be convinced of : -ya ikna olmak; -ye ikna olmak; aklı yatmak
                               be coordinated with : ile koordine etmek
          count up; count on; depend up; depend on : -ya güvenmek; -ye güvenmek
                                   be covered with : ile kaplı olmak
                                   be crowded with : ile dolu olmak
                              decide up; decide on : -ya karar vermek; -ye karar vermek
                                   be dedicated to : -ya adanmak; -ye adanmak
                                     be devoted to : -ya sadık olmak; -ye sadık olmak; kendini adamak
          be disappointed in; be disappointed with : -ya karşı ayrımcılıkta bulunmak; için hayal kırıklığına uğramak
                              distinguish ... from : -yı ...'dan ayırt etmek
                                  be divorced from : -dan boşanmak
                                      be done with : ile işi bitmek
                             dream of; dream about : -yı rüyasında görmek; -yi rüyasında görmek; hayal etmek
                                     be dressed in : -yı giymiş olmak; -yi giymiş olmak
                      be engaged in; be engaged to : ile meşgul olmak; ile nişanlı olmak
                                     be envious of : -yı kıskanmak
                                  be equipped with : ile donatılmış olmak
                                       escape from : -dan kaçmak; -den kaçmak
                                excel in; excel at : -da zirveye çıkmak; -de zirveye çıkmak
                                  be excited about : -dan ötürü heyecanlı olmak; -den ötürü heyecanlı olmak
                                 be exhausted from : -dan ötürü tükenmiş olmak; -den ötürü tükenmiş olmak; -dan ötürü bitkin olmak; -den ötürü bitkin olmak
                                        excuse for : -dan ötürü mazereti olmak; -den ötürü mazereti olmak
                                     be exposed to : -ya maruz kalmak; -ye maruz kalmak
                                    be faithful to : -ya sadık olmak; -ye sadık olmak
                                  be familiar with : -ya aşina olmak; -ye aşina olmak
                                         feel like : gibi hissetmek
                                         fight for : için dövüşmek
                                    be filled with : ile dolu olmak
                                  be finished with : -yı bitirmek; -yi bitirmek
                                    be filled with : ile dolu olmak
---------------------------------------------------------------------------------------------------------------------------
                                  be finished with : -yı bitirmek; -yi bitirmek
                                        be fond of : -dan hoşlanmak; -den hoşlanmak
                                      forget about : -yı unutmak; -yi unutmak
                                       forgive for : -dan ötürü affetmek; -den ötürü affetmek
                  be friendly to; be friendly with : -ya karşı arkadaşça olmak; -ye karşı arkadaşça olmak
                be frightened of; be frightened by : -dan korkmak; -den korkmak; -dan ürkmek; -den ürkmek
                                 be furnished with : ile döşeli olmak
                   What you think doesn't matter.  : Senin ne düşündüğün önemli değil. 
                                        prohibited : yasak
                                           rely on : güvenmek
                                             vivid : canlı
                                       brain drain : beyin göçü
                                             color : renk (Amerikan)
                                            colour : renk (İngiliz)
                                              gray : gri (Amerikan)
                                              grey : gri (İngiliz)
                        What color? ; What colour? : Ne renk? 
            What do you do? ; What about your job? : Ne iş yapıyorsun? ; İşin ne? 
                                                on : üst (temas varsa)
                                              over : üst (temas yoksa ve tam üstteyse)
                                             above : üst (temas yoksa ve tam üstte değilse)
                      He is over a hundred kilos.  : O yüz kilodan fazla. 
                                 He is above all.  : O herkesten üstün. 
                                             under : alt (tam alttaysa)
                                             below : alt (tam altta değilse)
                                           between : arasında (2 şey)
                                             among : arasında (2'den fazla şey)
                             Do you have the time? : Saatiniz var mı? ; Saatin var mı?
                               Do you have a time? : Vaktiniz var mı? (!) ; Vaktin var mı? (!)
                                 elementary school : ilkokul
                                       high school : lise
                                       get on well : iyi anlaşmak; iyi geçinmek
                                          get back : geri dönmek
                                      be gone from : -dan gitmiş olmak; -den gitmiş olmak
                   be grateful to; be grateful for : -ya minnettar olmak; -ye minnettar olmak
                                      be guilty of : -dan dolayı suçlu olmak; -den dolayı suçlu olmak
                                         hide from : -dan saklanmak; -den saklanmak
                                          hope for : -yı umut etmek; -yi umut etmek
                                    be innocent of : -dan dolayı masum olmak; -den dolayı masum olmak
                                         insist on : konusunda ısrar etmek
                                  be interested in : -ya ilgi duymak; -ya ilgi duymak
                                      introduce to : ile tanıştırmak
---------------------------------------------------------------------------------------------------------------------------
                                    be involved in : -ya dahil olmak; -ye dahil olmak; ilişkide olmak
                                     be jcalous of : -yı kıskanmak; -yi kıskanmak
                                         keep from : -yı ...'dan saklamak; -yi ...'dan saklamak
                                      be known for : ile tanınmak
                                     be limited to : ile sınırlı olmak
                                     be located in : -da yer almak (konumsal); -de yer almak (konumsal)
                                   look forward to : -yı dört gözle beklemek; -yi dört gözle beklemek
                          be made of; be made from : -dan yapılmış olmak; -den yapılmış olmak
                                     be married to : ile evli olmak
                                           preface : önsöz
                                          leverage : kaldıraç
                                            unique : benzersiz
                                          emphasis : vurgu
                                         premature : erken
                                       abstraction : sorgulama
                                          sequence : sıra
                                         conceived : gebe
                                         emphasize : vurgulamak
                                           inherit : miras almak
                                       abstraction : sorgulama
                                          prologue : önsöz
                                          behavior : davranış
                                         cope with : baş etmek
                                         implement : uygulamak
                                       thoroughout : boyunca
                                             shown : gösterilen
                                         verifying : doğrulanıyor
                                        accomplish : başarmak
                                          indicate : göstermek
                                         indicates : gösterir
                                        repository : depo
